6 6
+- - - - - -+
|E       B  |  
   - - - -  
| |       | |
 
|I|       |C|
         
| |       | |
   
| |       | |
   - - - - 
|P   J      |
+- - - - - -+