6 6
+- - - - - -+
 D E D D D D 
   - - - -  
|D|       |B|

|I|       |C|

|D|       | |

| |       |D|
   - - - - 
 P   J   E   
+- - - - - -+